00 00 00 00 00 00 00 00 00 00 00 00 00 00 00 00 00 00 00 00 00 00 00 00 00 00 00 00 00 00 00 00 00 00 00 00 00 00 00 00 00 00 00 00 00 00 00 00 00 00 00 00 00 00 00 00 00 00 00 00 00 00 00 00 00 00 00 00 00 00 00 00 00 00 00 00 00 00 00 00 00 00 00 00 00 00 00 00 00 00 00 00 00 00 00 00 00 00 00 00 00 00 00 00 00 00 00 00 00 00 00 00 00 00 00 00 00 00 00 00 00 00 00 00 00 00 00 00 00 00 00 00 00 00 00 00 00 00 00 00 00 00 00 00 00 00 00 00 00 00 00 00 00 00 00 00 00 00 00 00 00 00 00 00 00 00 00 00 00 00 00 00 00 00 00 00 00 00 00 00 00 00 00 00 00 00 00 00 00 00 00 00 00 00 00 00 00 00 00 00 00 00
00 00 00 00 00 00 00 00 00 00 00 00 00 00 00 00 00 00 00 00 00 00 00 00 00 00 00 00 00 00 00 00 00 00 00 00 00 00 00 00 00 00 00 00 00 00 00 00 00 00 00 00 00 00 00 00 00 00 00 00 00 00 00 00 00 00 00 00 00 00 00 00 00 00 00 00 00 00 00 00 00 00 00 00 00 00 00 00 00 00 00 00 00 00 00 00 00 00 00 00 00 00 00 00 00 00 00 00 00 00 00 00 00 00 00 00 00 00 00 00 00 00 00 00 00 00 00 00 00 00 00 00 00 00 00 00 00 00 00 00 00 00 00 00 00 00 00 00 00 00 00 00 00 00 00 00 00 00 00 00 00 00 00 00 00 00 00 00 00 00 00 00 00 00 00 00 00 00 00 00 00 00 00 00 00 00 00 00 00 00 00 00 00 00 00 00 00 00 00 00 00 00
08 14 12 08 14 12 08 14 12 08 14 12 08 14 12 08 14 12 08 14 12 08 14 12 08 14 12 08 14 12 08 14 12 08 14 12 00 00 00 00 00 00 00 00 00 00 00 00 00 00 00 00 00 00 00 00 00 00 00 00 00 00 00 00 00 00 00 00 00 00 00 00 00 00 00 00 00 00 00 00 00 00 00 00 00 00 00 00 00 00 00 00 00 00 00 00 00 00 00 00 00 00 00 00 00 00 00 00 00 00 00 00 00 00 00 00 00 00 00 00 00 00 00 00 00 00 00 00 00 00 00 00 00 00 00 00 00 00 00 00 00 00 00 08 14 12 00 00 00 08 14 12 00 00 00 08 14 12 00 00 00 00 00 00 00 00 00 00 00 00 00 00 00 00 00 00 00 00 00 00 00 00 00 00 00 00 00 00 00 00 00 00 00 00 00 00 00 00 00 00 00 00
07 13 11 07 13 11 07 13 11 07 13 11 07 13 11 07 13 11 07 13 11 07 13 11 07 13 11 07 13 11 07 13 11 07 13 11 00 00 00 00 00 00 00 00 00 00 00 00 00 00 00 00 00 00 00 00 00 00 00 00 00 00 00 00 00 00 00 00 00 00 00 00 00 00 00 00 00 00 00 00 00 00 00 00 00 00 00 20 00 00 00 00 00 00 00 00 00 00 00 00 00 00 00 00 00 00 00 00 00 00 00 00 00 00 00 00 00 00 00 00 00 00 00 00 00 00 00 00 00 00 00 00 00 00 00 00 00 00 00 00 00 00 00 07 13 11 00 00 00 07 13 11 00 00 00 07 13 11 00 00 00 00 00 00 00 00 00 00 00 00 00 00 00 00 00 00 00 00 00 00 00 00 00 00 00 00 00 00 00 00 00 00 00 00 00 00 00 00 00 00 00 00
06 04 10 06 04 10 06 04 10 06 04 10 06 04 10 06 04 10 06 04 10 06 04 10 06 04 10 06 04 10 06 04 10 06 04 10 00 00 00 00 00 00 00 00 00 00 00 00 00 00 00 00 00 00 00 00 00 00 00 00 00 00 00 00 00 00 00 00 00 00 00 00 00 00 00 00 00 00 00 00 00 00 00 00 00 00 18 19 16 00 00 00 00 00 16 00 00 00 00 00 00 00 00 00 00 00 00 00 00 00 20 00 00 00 00 00 00 00 00 00 00 00 00 00 00 00 00 00 00 00 00 00 00 00 00 00 00 00 00 00 00 00 00 06 04 10 00 00 00 06 04 10 00 00 00 06 04 10 00 00 00 00 00 00 00 00 00 00 00 00 00 00 00 00 00 00 00 00 00 00 00 00 00 00 00 00 00 00 00 00 00 00 00 00 00 00 00 00 00 00 00 00
05 03 09 05 03 09 05 03 09 05 03 09 05 03 09 05 03 09 05 03 09 05 03 09 05 03 09 05 03 09 05 03 09 05 03 09 00 00 00 00 00 00 00 00 00 00 00 00 00 00 00 00 00 00 00 00 00 00 00 00 00 00 00 00 00 00 20 00 00 00 17 17 16 17 17 17 16 17 17 17 17 17 17 21 22 22 22 22 22 22 22 22 22 22 22 23 00 00 00 00 00 00 00 00 00 00 00 17 17 18 19 16 17 00 00 00 00 00 00 00 00 00 00 00 00 00 00 00 00 00 00 00 00 00 00 00 00 00 00 00 00 00 00 05 03 09 00 00 00 05 03 09 00 00 00 05 03 09 00 00 00 00 00 00 00 00 00 00 00 00 00 00 00 00 00 00 00 00 00 00 00 00 00 00 00 00 00 00 00 00 00 00 00 00 00 00 00 00 00 00 00 00
00 02 00 00 02 00 00 02 00 00 02 00 00 02 00 20 02 00 00 02 00 00 02 00 00 02 00 00 02 00 20 02 00 00 02 00 00 00 20 00 00 00 00 00 00 00 00 00 20 00 00 00 00 00 00 00 00 00 00 00 00 16 00 00 00 18 19 16 00 00 21 22 22 22 22 22 22 22 22 22 22 22 26 25 25 25 25 25 25 25 25 25 25 25 25 25 27 22 23 00 00 16 17 00 21 22 22 22 22 22 22 22 22 22 22 22 23 17 17 17 17 17 16 17 17 17 17 17 17 16 17 17 17 17 17 17 17 00 00 00 00 00 00 00 02 00 00 00 00 00 02 00 00 00 20 00 02 00 00 00 00 00 00 00 00 00 00 00 00 00 00 20 00 00 00 00 00 00 00 00 00 00 00 00 00 00 00 00 00 00 00 00 00 00 00 20 00 00 00 00 00 00
17 01 17 17 01 16 17 01 17 17 01 17 17 01 18 19 01 16 17 01 17 17 01 17 17 01 17 16 01 18 19 01 17 17 01 17 00 18 19 00 00 00 00 16 17 17 00 18 19 00 00 00 00 00 17 16 21 22 22 22 22 22 22 22 22 22 22 22 22 26 25 25 25 25 25 25 25 25 25 25 25 25 25 25 25 25 25 25 25 25 25 25 25 25 25 25 25 25 25 27 22 22 22 26 25 25 25 25 25 25 25 25 25 25 25 25 25 27 22 22 22 22 22 22 22 22 22 22 22 22 22 22 22 22 22 22 23 00 00 16 17 00 00 00 01 00 16 17 00 00 01 16 00 18 19 00 01 00 00 00 00 00 00 00 00 00 00 00 00 16 18 19 17 00 00 00 00 00 00 00 00 00 00 00 00 00 00 00 00 00 00 00 00 16 18 19 17 17 00 00 00 00
29 29 29 29 29 29 29 29 29 29 29 29 29 29 29 29 29 29 29 29 29 29 29 29 29 29 29 29 29 29 29 29 29 29 29 29 22 22 22 22 22 22 22 22 22 22 22 22 22 22 22 22 22 22 22 26 25 25 25 25 25 25 25 25 25 25 25 25 25 25 25 25 25 25 25 25 25 25 25 25 25 25 25 25 25 25 25 25 25 25 25 25 25 25 25 25 25 25 25 25 25 25 25 25 25 25 25 25 25 25 25 25 25 25 25 25 25 25 25 25 25 25 25 25 25 25 25 25 25 25 25 25 25 25 25 25 25 27 22 22 22 22 22 22 22 22 22 22 22 22 22 22 22 22 22 22 22 23 15 15 15 15 15 15 15 15 15 15 21 22 22 22 23 15 15 15 15 15 15 15 15 15 15 15 15 15 15 15 15 15 15 21 22 22 22 22 22 22 22 22 22 22
32 32 32 32 32 32 32 32 32 32 32 32 32 32 32 32 32 32 32 32 32 32 32 32 32 32 32 32 32 32 32 32 32 32 32 32 25 25 25 25 25 25 25 25 25 25 25 25 25 25 25 25 25 25 25 24 25 25 25 25 25 25 25 25 25 25 25 25 25 25 25 25 25 25 25 25 25 25 25 25 25 25 25 25 25 25 25 25 25 25 25 25 25 25 25 25 25 25 25 25 25 25 25 25 25 25 25 25 25 25 25 25 25 25 25 25 25 25 25 25 25 25 25 25 25 25 25 25 25 25 25 25 25 25 25 25 25 25 25 25 25 25 25 25 25 25 25 25 25 25 25 25 25 25 25 25 25 25 27 22 22 22 22 22 22 22 22 26 25 25 25 25 25 27 22 22 22 22 22 22 22 22 22 22 22 22 22 22 22 22 26 25 25 25 25 25 25 25 25 25 25 25
